1,1,1,1,1,1,1,1,1,1,1,1,1,1,1,1,1,1,1,55,1,1,55,1,1,1,1,1,1,1,1,1,1,1,55,1,1,1,1,1,1,1,1,1,1,1,1,1,
1,1,1,1,1,1,1,1,1,1,1,1,1,1,1,1,1,1,1,55,1,1,55,1,1,1,1,1,1,1,1,1,1,1,55,1,1,1,1,1,1,1,1,1,1,1,1,1,
1,1,1,1,1,1,1,1,1,1,1,1,1,1,1,1,1,1,1,55,1,1,55,1,1,1,1,1,1,1,1,1,1,1,55,1,1,1,1,1,1,1,1,1,1,1,1,1,
1,1,1,1,1,1,1,1,1,1,1,1,1,1,1,1,1,1,1,55,1,1,55,1,1,1,1,1,1,1,1,1,1,1,55,1,1,1,1,1,1,1,1,1,1,1,1,1,
1,1,1,1,1,1,1,1,1,1,1,1,1,1,1,1,1,1,1,87,1,1,55,1,1,1,1,1,1,1,1,1,1,1,55,1,1,1,1,1,1,1,1,1,1,1,1,1,
1,1,1,1,1,1,1,1,1,1,1,1,1,1,1,1,1,1,1,55,1,1,55,1,1,1,1,1,1,1,1,1,1,1,55,1,1,1,1,1,1,1,1,1,1,1,1,1,
1,1,1,1,1,1,1,1,1,1,1,1,1,1,1,1,1,1,1,55,1,1,55,1,152,1,1,1,1,1,1,1,1,1,55,1,1,1,1,1,1,1,1,1,1,1,1,1,
1,1,1,1,1,1,1,1,1,1,1,1,1,1,1,1,1,1,1,55,1,1,55,1,88,1,1,1,1,1,1,1,1,1,55,1,1,1,1,1,1,1,1,1,1,1,1,1,
1,1,1,1,1,1,1,1,1,1,1,1,1,1,1,1,1,1,1,55,1,1,55,214,215,2147483863,216,1,1,1,1,1,1,1,55,1,1,1,1,1,1,1,1,1,1,1,1,1,
1,1,1,1,1,1,1,1,1,1,1,1,1,1,1,1,1,1,151,55,1,1,55,1,1,1,1,1,1,1,1,1,1,1,87,1,1,1,1,1,1,1,1,1,1,1,1,1,
1,1,1,1,1,1,1,1,1,1,1,1,1,1,1,1,1,1,88,55,1,1,55,1,1,1,1,1,1,1,246,1,306,1,55,1,1,1,1,1,1,1,1,1,1,1,1,1,
1,1,1,1,1,1,1,1,1,1,1,1,1,1,1,1,19,20,20,20,118,1,55,1,1,1,1,1,1,1,214,215,216,1,55,1,1,1,1,151,151,86,1,1,1,1,1,1,
1,1,1,1,1,1,1,1,1,1,1,1,1,1,1,1,51,1,1,1,53,1,87,1,1,1,280,1,86,183,1,1,1,1,87,1,151,1,19,20,20,20,20,21,1,1,1,1,
1,1,1,1,1,1,1,1,1,1,1,1,1,1,1,1,51,52,1,1,53,1,55,1,1,1,19,20,20,21,1,1,1,1,55,1,151,1,51,1,1,1,1,53,1,1,1,1,
1,1,1,1,1,1,1,1,1,1,1,1,1,1,1,1,51,1,1,1,53,1,87,151,1,1,51,1,1,53,1,1,1,2147483956,88,86,1,86,51,1,1,1,1,53,1,1,1,1,
1,1,1,1,1,1,1,1,1,1,1,1,1,1,1,1,51,1,1,1,53,1,55,86,1,117,148,1,1,53,179,179,179,19,20,20,20,20,148,1,1,1,1,53,1,1,1,1,
1,1,1,1,1,1,1,1,1,1,1,1,1,1,1,1,51,1,1,52,147,20,20,20,20,148,1,1,1,53,1,1,1,51,1,1,1,1,1,1,1,1,1,53,1,1,1,1,
1,1,1,1,1,1,1,1,1,1,1,1,1,86,1,1,51,1,1,1,1,1,1,1,1,1,1,1,1,53,1,1,1,51,1,1,1,1,1,1,1,1,1,53,1,1,1,1,
1,1,1,1,1,1,1,1,1,1,1,1,19,20,20,20,148,1,1,1,1,1,1,1,52,1,1,1,1,53,23,23,23,51,1,1,1,1,1,1,1,1,1,53,1,1,1,1,
1,1,1,1,1,1,1,1,1,1,1,1,51,1,1,1,1,1,1,1,1,1,1,1,1,1,1,1,1,147,20,20,20,148,1,1,1,1,1,1,1,1,1,53,1,1,1,1,
1,1,1,1,1,1,1,1,1,1,1,1,51,1,1,1,1,1,1,1,1,1,1,52,1,1,1,1,1,1,1,1,1,1,1,1,52,1,1,1,1,1,1,53,1,1,1,1,
1,1,1,1,1,1,1,1,19,20,20,20,148,1,1,1,1,1,1,1,1,1,1,1,1,1,52,1,1,1,1,1,1,1,1,52,1,1,52,1,1,1,1,53,1,1,1,1,
1,1,1,1,1,1,1,1,51,1,1,1,1,1,1,1,1,1,1,1,1,1,1,1,1,1,1,1,1,1,1,1,1,1,1,1,1,1,1,1,1,1,1,53,1,1,1,1,
1,1,1,1,1,1,1,1,51,1,1,1,1,1,1,1,1,1,1,1,1,1,1,1,1,1,1,1,1,1,1,1,1,1,1,1,1,1,1,1,1,1,1,53,1,1,1,1